1111111111111111111111111111111111
1000E000000C0000000000000N000C0001
1010010100100000101001000000010101
10010010010101011P10010000C0010011
1100000000C0000000000N0000001C1001
1111111111111111111111111111111111
