1111111111111111111111111111111111
1E000000000C0000000000000N000C0001
1010010100100000101001000000010101
10100100101010100010010000C0010101
1P00000000C0000000000N0000000C0001
1111111111111111111111111111111111
