1111111111111
10010000N00C1
1000011111001
1P0011E000N01
1111111111111
