11111111111111111111111
1C000000001111111P00111
100000111000000000000C1
1E0000111C1111100C00111
11111111111111111111111