11111111111111111111111
1000000001C10C000000001
1011001C010100100P00111
101C00111101001111110C1
1E100000000000000000011
11111111111111111111111