1111111111111111111111111111111111
1C0000000001C0000000000000000000C1
1010011111E10101011111111111011111
1010C100C11101010100C00000010000P1
10101101010001010000000000C10111C1
1010000101111101010111111111000111
10111111000000010100000000000000C1
1C00000001111111C10001001000100001
1111111111111111111111111111111111